111111111111111111111111111
100000000000000000000000001
101111111111111111111111101
101000000000000000000000101
101011111111111111111110101
101000000000E00000000010101
101111111111111111111110101
101000000000000000000000101
101111111111111111111110101
101000000000000000000000101
101111111111111111111111101
100000000000000000000000001
111111111111111111111111111
